XXXXXXXXXXXXXXXXXXXXXXXXXXX
XWWWWWWWWWWWWWWWWWWWWWWWWWX
XWFFTFFTFFFFFWFFFFFTFFFFFWX
XWFWFWWFWWWWFWFWWWWFWWWWFWX
XWFWFWWFWWWWFWFWWWWFWWWWFWX
XWSFTFFTFTFFTFTFFTFTFFFFSWX
XWFWWWWFWFWWWWWWWFWFWWWWFWX
XWFFFFFTWFFFFWFFFFWTFFFFFWX
XWWWWWWFWWWWFWFWWWWFWWWWWWX
XWZZZZWFWFFFTCTFFFWFWZZZZWX
XWZZZZWFWFWWWGWWWFWFWZZZZWX
XWWWWWWFWFW0ZZZ2WFWFWWWWWWX
XDFFFFFTFTWZZZZZWTFTFFFFFDX
XWWWWWWFWFWZZ1ZZWFWFWWWWWWX
XWZZZZWFWFWWWWWWWFWFWZZZZWX
XWZZZZWFWFFFTPTFFFWFWZZZZWX
XWWWWWWFWWWWFWFWWWWFWWWWWWX
XWFFFFFTWFFFFWFFFFWTFFFFFWX
XWFWWWWFWFWWWWWWWFWFWWWWFWX
XWSFFFFTFTFFTFTFFTFTFFFFSWX
XWFWWWWFWWWWFWFWWWWFWWWWFWX
XWFWWWWFWWWWFWFWWWWFWWWWFWX
XWFFFFFTFFFFFWFFFFFTFFFFFWX
XWWWWWWWWWWWWWWWWWWWWWWWWWX
XXXXXXXXXXXXXXXXXXXXXXXXXXX